####################
# S    #   #F      #
#    ###   ###  ####
#    #     #       #
###   ##        #  #
###   ##   #    #  #
#          #    #  #
####################