####################
# S    #   #       #
#    ###   ###  ####
#    #     #       #
###   ##        #  #
###   ##   #    #  #
#          #    #F #
####################